WWWWWWWWWWWWWWWWWWWWWWWWW
W--AW---------W--------FW
W---W---W---------------W
W-------W-----W---------W
W--B-WWW----------------W
W-------W-----W---------W
W---W-------------------W
W----WWW------W---------W
W---W-------------------W
W-------W-----W---------W
W--C-WWW----------------W
W---W---W-----W---------W
W-------W---------------W
W---W---W-----W---------W
W---W-------------------W
W-------------W---------W
W---W---W---------------W
W--DW---W-----W---------W
W---W---W-----W---------W
WWWWWWWWWWWWWWWWWWWWWWWWW