WWWWWWWWWWWWWWWWWWWWWWWWWW
WC-W---W-------W----W--FW
W--W---W-------W----W---W
W--W---W-------W----W---W
W--W---W-------W----W---W
W--W---W-------W----W---W
W-----------------------W
WA---------------------BW
W-----------------------W
W--W---W-------W----W---W
W--W---W-------W----W---W
W--W---W---F---W----W---W
W--W---W-------W----W---W
W-----------------------W
W-----------------------W
W-----------------------W
W--W---W-------W----W---W
W--W---W-------W----W---W
W--W---W-------W----W--DW
WWWWWWWWWWWWWWWWWWWWWWWWWW