WWWWWWWWWWWWWWWWWWWWWWWWW
WA--W-------------------W
W---W--WWWWWWWWWWW------W
W---W---------------W---W
W---W---W---W---W---W---W
W---W---------------W---W
WB-----WWWWWWWWWWW--W---W
W---W----W-----W-----W--W
W--------W-----W-----W--W
W---W----W-----------W--W
W---W----W-----F-----W--W
WC--W----------------W--W
W---W--WWWWWWWWWWW------W
W---W---------------W---W
W---W---W---W---W---W---W
W---W---------------W---W
W------WWWWWWWWWWW--W---W
W-------------------W---W
WD----------------------W
WWWWWWWWWWWWWWWWWWWWWWWWW