WWWWWWWWWWWWWWWWWWWWWWWWW
W-----------A-----------W
W---W----W---W---W---W--W
W---W----W---W---W---W--W
W---W----W---W---W---W--W
W---W----W---W---W---W--W
W---W----W---W---W---W--W
W---W----W---W---W---W--W
W-----------------------W
WC--WWWW----F---WWWW---DW
W-----------------------W
W---W----W---W---W---W--W
W---W----W---W---W---W--W
W---W----W---W---W---W--W
W---W----W---W---W---W--W
W---W----W---W---W---W--W
W---W----W---W---W---W--W
W-----------------------W
W-----------B-----------W
WWWWWWWWWWWWWWWWWWWWWWWWW