WWWWWWWWWWWWWWWWWWWWWWWWW
W--EW---------W--------FW
W---W---W---------------W
W-------W-----W---------W
W--P-WWW----------------W
W-------W-----W---------W
W---W-------------------W
W----WWW------W---------W
W---W-------------------W
W-------W-----W---------W
W--E-WWW----------------W
W---W---W-----W---------W
W-------W---------------W
W---W---W-----W---------W
W---W-------------------W
W-------------W---------W
W---W---W---------------W
W--EW---W-----W---------W
W---W---W-----W---------W
WWWWWWWWWWWWWWWWWWWWWWWWWW