WWWWWWWWWWWWWWWWWWWWWWWWWW
WE-W---W-------W----W--FW
W--W---W-------W----W---W
W--W---W-------W----W---W
W--W---W-------W----W---W
W--W---W-------W----W---W
W-----------------------W
W-----------P-----------W
W-----------------------W
W--W---W-------W----W---W
W--W---W-------W----W---W
W--W---W---E---W----W---W
W--W---W-------W----W---W
W-----------------------W
W-----------------------W
W-----------------------W
W--W---W-------W----W---W
W--W---W-------W----W---W
W--W---W-------W----W--EW
WWWWWWWWWWWWWWWWWWWWWWWWWW