WWWWWWWWWWWWWWWWWWWWWWWWW
WP--W-------------------W
W---W--WWWWWWWWWWW------W
W---W---------------W---W
W---W---W---W---W---W---W
W---W---------------W---W
WE-----WWWWWWWWWWW--W---W
W---W----W-----W-----W--W
W--------W-----W-----W--W
W---W----W-----------W--W
W---W----W-----F-----W--W
WE--W----------------W--W
W---W--WWWWWWWWWWW------W
W---W---------------W---W
W---W---W---W---W---W---W
W---W---------------W---W
W------WWWWWWWWWWW--W---W
W-------------------W---W
WE----------------------W
WWWWWWWWWWWWWWWWWWWWWWWWW