WWWWWWWWWWWWWWWWWWWWWWWWW
WP---------------------EW
W-------WWWWWWWWWWWWW---W
W---W-------------------W
W---W-----WWWWWWWW------W
W---W------------W------W
W---W------------W------W
W---W----WWWWW---W------W
W---W----W-------W------W
W---W----W-F-----W------W
W---W----W-------W------W
W---W------------W------W
W---W------------W------W
W---W----WWWWWWWWW------W
W---W-------------------W
W---W-------------------W
W-------WWWWWWWWWWWWW---W
W-----------------------W
WE---------------------EW
WWWWWWWWWWWWWWWWWWWWWWWWW