WWWWWWWWWWWWWWWWWWWWWWWWW
W-----------------------W
W--W---W--W--W--W---W---W
W--W-P-W--W--W--W-E-W---W
W---WWW---W--W---WWW----W
W---------W--W----------W
W--WWWWW--W--W--WWWWW---W
W---------W--W----------W
W--W---W--W--W--W---W---W
W--W-E-W--W--W--W-E-W---W
W---WWW---W--W---WWW----W
W---------W--W----------W
W---------W--W----------W
W-----------------------W
W--WWWWW--------WWWWW---W
W-----------------------W
W--W--W---WWW---W---W---W
W--W--W--W-F-W--W---W---W
W--W--W---------W---W---W
WWWWWWWWWWWWWWWWWWWWWWWWW