WWWWWWWWWWWWWWWWWWWWWWWWW
W-----------P-----------W
W---W----W---W---W---W--W
W---W----W---W---W---W--W
W---W----W---W---W---W--W
W---W----W---W---W---W--W
W---W----W---W---W---W--W
W---W----W---W---W---W--W
W-----------------------W
WE--WWWW----F---WWWW---EW
W-----------------------W
W---W----W---W---W---W--W
W---W----W---W---W---W--W
W---W----W---W---W---W--W
W---W----W---W---W---W--W
W---W----W---W---W---W--W
W---W----W---W---W---W--W
W-----------------------W
W-----------E-----------W
WWWWWWWWWWWWWWWWWWWWWWWWW