WWWWWWWWWWWWWWWWWWWWWWWWW
W--------W-------------EW
W--------W--------------W
W--------W--------------W
W--------W--------------W
W--------W--------------W
W--------W--------------W
W--------W--------------W
W--------W--------------W
W--------W-------------EW
W--------W--------------W
W--------W--------------W
W-P------W--------------W
W--------W--------------W
W--------W--------------W
W--------W--------------W
W--------W--------------W
W--------W--------------W
W--------W-------------EW
WWWWWWWWWWWWWWWWWWWWWWWWW